....................
....................
.........O..........
....................
....................
....            ....
....            ....
....            ....
....            ....
....            ....
....            ....
....            ....
....            ....
....            ....
....            ....
....................
....................
.........X..........
....................
....................
